11 
* 
8   
*
1  
*
00:1-0 
#
01:1-2 
#
02:1-3 
#
03:1-5 
#
04:1-1 
*
00000000000
00000000000
00111000000
00111001110
00111001110
00000001110
00000000000
00000000000
*
00 00 00 00 00 00 00 00 00 02 00 
00 00 00 00 00 00 00 00 00 02 00
00 00 03 03 03 00 02 02 02 02 00
00 00 03 03 03 00 02 03 03 03 00
00 00 03 03 03 00 02 03 03 03 00
00 00 00 00 00 00 02 03 03 03 00
00 00 00 02 02 02 02 00 00 00 00
00 00 00 02 00 00 00 00 00 00 00