30 
*  
30   
*
1   
*
00-1-0 
#
01-1-1 
#
02-1-2 
#
03-1-3 
#
04-1-4 
#
05-1-5
#
06-1-6
#
07-1-7
#
08-1-8
#
09-1-9
#
10-1-17
#
11-1-18
#
12-1-19
#
13-1-27
#
14-1-28
#
15-1-29
#
16-1-38
*
000000000000000000000000000000
000000000000000000000000000000
000000000000000000000000000001
000000000000000000000000000011
000000000000000000011111111111
000000000000000000111111111111
000000000000000001111111111110
000000000000000001111000000000
000000000000000001111000000000
000000000000000001110000000000
000000000000000001100000000000
000000000000000000000000000000
000000000000000001100000000000
000000000000000001110000000000
000000000000000001110000000000
000000000000000001110000000000
000000000000000001110000000000
000000000000000001110000000000
000000000000000001110000000000
000000000000000001110000000000
000000000000000001110000000000
000000000000000001110000000000
000000000000000001110000000000
000000000000000001110000000000
000000000000000011110000000000
000000000000000111110000000000
000111111111111111111000000001
111111111111111111111000000111
111111111111111111111111111111
111111111111111111111111111111
*
00 00 00 00 00 00 00 00 00 00 00 00 00 00 00 00 00 00 00 00 00 00 00 00 00 00 00 00 00 00
00 00 00 00 00 00 00 00 00 00 00 00 00 00 00 00 00 00 00 00 00 00 00 00 00 00 00 00 00 00
00 00 00 00 00 00 00 00 00 00 00 00 00 00 00 00 00 00 00 00 00 00 00 00 00 00 00 00 00 03
00 00 00 00 00 00 00 00 00 00 00 00 00 00 00 00 00 00 00 00 00 00 00 00 00 00 00 00 03 03
00 00 00 00 00 00 00 00 00 00 00 00 00 00 00 00 00 00 00 03 03 03 03 03 03 03 03 03 03 03
00 00 00 00 00 00 00 00 00 00 00 00 00 00 00 00 00 00 03 03 03 03 03 03 03 03 03 03 03 03
00 00 00 00 00 00 00 00 00 00 00 00 00 00 00 00 00 03 03 03 03 03 03 03 03 03 03 03 03 00
00 00 00 00 00 00 00 00 00 00 00 00 00 00 00 00 00 03 03 03 03 00 00 00 00 00 00 00 00 00
00 00 00 00 00 00 00 00 00 00 00 00 00 00 00 00 00 03 03 03 03 00 00 00 00 00 00 00 00 00
00 00 00 00 00 00 00 00 00 00 00 00 00 00 00 00 00 03 03 03 00 00 00 00 00 00 00 00 00 00
00 00 00 00 00 00 00 00 00 00 00 00 00 00 00 00 00 07 08 09 00 00 00 00 00 00 00 00 00 00
00 00 00 00 00 00 00 00 00 00 00 00 00 00 00 00 00 10 11 12 00 00 00 00 00 00 00 00 00 00
00 00 00 00 00 00 00 00 00 00 00 00 00 00 00 00 00 13 14 15 00 00 00 00 00 00 00 00 00 00
00 00 00 00 00 00 00 00 00 00 00 00 00 00 00 00 00 03 03 03 00 00 00 00 00 00 00 00 00 00
00 00 00 00 00 00 00 00 00 00 00 00 00 00 00 00 00 03 03 03 00 00 00 00 00 00 00 00 00 00
00 00 00 00 00 00 00 00 00 00 00 00 00 00 00 00 00 03 03 03 00 00 00 00 00 00 00 00 00 00
00 00 00 00 00 00 00 00 00 00 00 00 00 00 00 00 00 03 03 03 00 00 00 00 00 00 00 00 00 00
00 00 00 00 00 00 00 00 00 00 00 00 00 00 00 00 00 03 03 03 00 00 00 00 00 00 00 00 00 00
00 00 00 00 00 00 00 00 00 00 00 00 00 00 00 00 00 03 03 03 00 00 00 00 00 00 00 00 00 00
00 00 00 00 00 00 00 00 00 00 00 00 00 00 00 00 00 03 03 03 00 00 00 00 00 00 00 00 00 00
00 00 00 00 00 00 00 00 00 00 00 00 00 00 00 00 02 03 03 03 00 00 00 00 00 00 00 00 00 00
00 00 00 00 00 00 00 00 00 00 00 00 00 00 00 02 02 03 03 03 02 00 00 00 00 00 00 00 00 00
00 00 00 00 00 00 00 00 00 00 00 00 00 00 00 02 02 03 03 03 02 00 00 00 00 00 00 00 00 00
00 00 00 00 00 00 00 00 00 00 00 00 00 00 00 02 02 03 03 03 02 02 00 00 00 00 00 00 00 02
00 00 02 02 02 02 02 02 02 02 02 02 02 02 02 02 03 03 03 03 02 02 00 00 00 00 00 02 02 02
00 02 02 02 02 02 02 02 02 02 02 02 02 02 02 03 03 03 03 03 02 02 00 00 00 02 02 02 02 02
02 02 02 03 03 03 03 03 03 03 03 03 03 03 03 03 03 03 03 03 03 02 02 02 02 02 02 02 02 03
03 03 03 03 03 03 03 03 03 03 03 03 03 03 03 03 03 03 03 03 03 02 02 02 02 02 02 03 03 03
03 03 03 03 03 03 03 03 03 03 03 03 03 03 03 03 03 03 03 03 03 03 03 03 03 03 03 03 03 03
03 03 03 03 03 03 03 03 03 03 03 03 03 03 03 03 03 03 03 03 03 03 03 03 03 03 03 03 03 03
*
1,1:1
#
1,2:1
#
1,3:1
#
5,6:2
#
6,6:2
#
4,4:3
#
1,5:3
#
6,2:3
#
3,6:4
#
4,8:4
#
7,2:5
#
7,7:5
#
7,5:6
#
8,7:7




